WE textures/EG3.xpm

NO		 textures/EG1.xpm



SO textures/EG2.xpm
EA textures/EG4.xpm

F  218, 177, 130
C 135,206,235

1111111111111111111111111
1000100010001000100010001
1010001010101010101010101
1000100000101000000010001
1010111110101010101010101
1000100010101 00100010001
1010101010111010101010101
1000000010000000100010001
1010101010101010101010101
1000100010001000100010001
1010111110101010101010101
1000100010001000100010001
1010101010101010101010101
1000100010001E00100010001
1010101010101010101010101
1000000010001111100010001
1010100010101010101010101
1000100000001000100000001
1010101010101010101010101
1000100010001000100010001
1111111111111111111111111