NO textures/greystone.xpm
SO textures/mossy.xpm
WE textures/bluestone.xpm
EA textures/purplestone.xpm
F 220,100,0
C 225,30,0

111111
1E01W1
101001
110001
111111
